1111111111111111111
1000000C00000000001
100C0000000000C0001
1000000000000000001
1E000000000C00000P1
1111111111111111111