11111111111
1C0000000C1
10000000001
10000000001
10000000001
10000E00001
10000000001
10000000001
10000000001
1C000P000C1
11111111111