11111111
100001C1
1E000101
11111111
1P000001
11111111