111111111111111111111
100C100C100C100C100C1
101010101010101010101
101010101010101010101
101010101010101010101
101010101010101010101
101010101010101010101
101000100010001000101
100111111111111111001
1E00000000000000000P1
111111111111111111111