111111111
1000000C1
1000P0001
1E0000001
111111111