111111111111111111111
100C100C100C100C100C1
101010101010101010101
101010101010101010101
101010101010101010101
101010101010101010101
101010101010101010101
101000100010001000101
100111111111111111001
1E00000000000000000P1
111111111111111111111

1111111111111111111
1000000C00000000001
100C0000000000C0001
1000000000000000001
1E000000000C00000P1
1111111111111111111

11111111111
1C0000000C1
10000000001
10000000001
10000000001
10000E00001
10000000001
10000000001
10000000001
1C000P000C1
11111111111